1111111111111111
10010000000000C1
1000011111000001
1P0000CE00000001
1111111111111111