1111111111111111
1C01000C00C000C1
11C010101100C001
1P0000CE000010C1
1111111111111111